JAVASCRIPT: 이벤트가 발생했을때 조건을 확인하고 맞았을 경우, 미리 지정해둔 약속된 명령을 실행하는 것.

[변수 선언] 
let (변수명) --> let name
: 변수 이름은 항상 소문자로 하기

[할당]
(변수명) = (데이터) --> name = "철수"

[선언 + 할당]
let (변수명) = (데이터) --> let name = "철수"

'=' : 대입하다

[변수의 상수와 종류의 특징]

- var, let, const

이름 중복(재선언): var
데이터 수정(재할당): var, let

변수는 let, 상수는 const
작명규칙 -> camelCase, snake_case 


[크롬 개발자 도구]
요소(Elements) : HTML을 분석하고 수정해볼 수 있는 도구
콘솔(Console) : 현재 로딩된 페이지에서 자바스크립트를 시험하거나 로그/오류 메세지 등을 확인할 수 있는 도구
소스(Resources) : 현재 로딩된 페이지에서 사용된 리소스를 열람할 수 있는 도구
네트워크(Network) : 서버와의 통신 내역을 보여주는 도구
성능(Audits) : 웹 어플리케이션의 성능을 향상시킬 방법을 컨설팅해주는 도구


----------

[배열]

const array =["배열]

1. 배열의 길이 구하기 : array.length
2. 배열의 값 꺼내기 : array[숫자(인덱스)]
3. 배열 맨 뒤에 값 추가 : array.push()
4. 배열 맨 마지막 값 삭제 : array.pop()
5. 배열 요소 정렬 : array.sort()
6. 배열 데이터 확인 : array.includes(값)
7. 배열 2개 연결 : array.concat(array2)
8. 배열 문자로 만들기 : array.join()
9. 배열 분리 : array.slice()
10. 배열에서 원하는 요소 뽑기 : array.filter()
11. 배열의 모든요소 변경 : array.map()